[1, 2, 4, 8, 5, 6, 3, 11, 9, 10, 7, 0, 13, 14, 15, 12]
[1, 2, 3, 4, 5, 6, 7, 8, 13, 9, 11, 12, 10, 14, 0, 15]
[1, 2, 3, 4, 0, 6, 7, 8, 5, 14, 10, 11, 9, 13, 15, 12]
[1, 2, 3, 4, 5, 6, 7, 8, 10, 13, 11, 12, 0, 9, 14, 15]
[1, 2, 4, 0, 5, 7, 3, 8, 9, 6, 10, 12, 13, 14, 11, 15]
[1, 2, 3, 4, 6, 9, 7, 8, 5, 0, 10, 11, 13, 14, 15, 12]
[1, 2, 3, 4, 0, 6, 7, 8, 5, 10, 15, 11, 9, 13, 14, 12]
[1, 0, 2, 4, 5, 6, 3, 7, 9, 10, 12, 8, 13, 14, 11, 15]
[2, 0, 3, 4, 1, 5, 6, 7, 9, 10, 11, 8, 13, 14, 15, 12]
[1, 2, 3, 4, 5, 6, 11, 7, 9, 10, 8, 12, 13, 14, 0, 15]
[1, 2, 3, 4, 5, 6, 7, 8, 9, 11, 12, 15, 13, 10, 0, 14]
[1, 2, 3, 4, 6, 7, 0, 8, 5, 10, 11, 12, 9, 13, 14, 15]
[5, 1, 2, 4, 0, 6, 3, 8, 9, 10, 7, 12, 13, 14, 11, 15]
[1, 2, 3, 4, 5, 6, 7, 8, 10, 13, 11, 12, 9, 14, 0, 15]
[1, 2, 3, 4, 5, 11, 6, 8, 9, 0, 7, 12, 13, 10, 14, 15]
[1, 2, 4, 7, 5, 6, 0, 3, 9, 10, 11, 8, 13, 14, 15, 12]
[1, 0, 2, 4, 5, 6, 3, 8, 9, 11, 7, 12, 13, 10, 14, 15]
[1, 2, 3, 4, 5, 6, 7, 8, 9, 14, 12, 0, 13, 11, 10, 15]
[1, 0, 3, 4, 5, 2, 6, 7, 9, 10, 12, 8, 13, 14, 11, 15]
[1, 2, 3, 4, 5, 6, 7, 8, 9, 14, 10, 0, 13, 11, 15, 12]
[5, 1, 3, 4, 0, 2, 7, 8, 9, 6, 10, 12, 13, 14, 11, 15]
[5, 1, 2, 3, 0, 6, 7, 4, 9, 10, 11, 8, 13, 14, 15, 12]
[1, 2, 3, 4, 5, 7, 0, 8, 10, 6, 11, 12, 9, 13, 14, 15]
[1, 2, 7, 3, 0, 5, 6, 4, 9, 10, 11, 8, 13, 14, 15, 12]
[1, 2, 3, 4, 5, 6, 7, 8, 13, 9, 10, 11, 14, 15, 0, 12]
[1, 6, 2, 3, 5, 7, 0, 4, 9, 10, 11, 8, 13, 14, 15, 12]
[1, 2, 3, 4, 5, 6, 11, 7, 9, 14, 10, 8, 0, 13, 15, 12]
[1, 2, 3, 4, 5, 6, 7, 8, 9, 10, 12, 15, 0, 13, 14, 11]
[1, 2, 3, 4, 0, 5, 7, 8, 9, 6, 15, 11, 13, 10, 14, 12]
[1, 2, 3, 4, 0, 5, 7, 8, 10, 6, 11, 12, 9, 13, 14, 15]
[1, 2, 4, 8, 5, 6, 0, 3, 9, 10, 7, 12, 13, 14, 11, 15]
[1, 0, 3, 4, 6, 2, 7, 8, 5, 10, 11, 12, 9, 13, 14, 15]
[1, 2, 7, 3, 5, 6, 11, 4, 9, 10, 8, 0, 13, 14, 15, 12]
[1, 2, 3, 4, 5, 6, 7, 8, 9, 11, 14, 0, 13, 10, 15, 12]
[1, 2, 3, 4, 5, 6, 7, 8, 9, 10, 12, 15, 13, 14, 0, 11]
[1, 3, 7, 4, 5, 2, 0, 8, 9, 6, 10, 12, 13, 14, 11, 15]
[1, 2, 3, 4, 5, 6, 0, 8, 9, 10, 7, 15, 13, 14, 12, 11]
[1, 2, 3, 4, 5, 6, 7, 8, 10, 0, 15, 11, 9, 13, 14, 12]
[1, 2, 3, 0, 5, 6, 7, 4, 9, 10, 15, 8, 13, 14, 12, 11]
[2, 0, 3, 4, 1, 6, 7, 8, 5, 10, 11, 12, 9, 13, 14, 15]
[2, 0, 3, 4, 1, 6, 7, 8, 5, 9, 11, 12, 13, 10, 14, 15]
[1, 2, 3, 4, 5, 6, 7, 8, 9, 11, 14, 12, 0, 13, 10, 15]
[1, 2, 3, 4, 5, 6, 7, 8, 14, 0, 10, 12, 9, 13, 11, 15]
[1, 2, 3, 4, 5, 6, 11, 7, 9, 10, 15, 0, 13, 14, 12, 8]
[1, 2, 8, 3, 5, 6, 0, 4, 9, 10, 7, 11, 13, 14, 15, 12]
[1, 6, 2, 3, 0, 5, 7, 4, 9, 10, 11, 8, 13, 14, 15, 12]
[1, 2, 7, 3, 5, 6, 11, 4, 9, 0, 10, 8, 13, 14, 15, 12]
[1, 2, 3, 4, 5, 6, 7, 8, 13, 9, 10, 12, 14, 11, 0, 15]
[5, 1, 3, 4, 0, 2, 6, 7, 9, 10, 11, 8, 13, 14, 15, 12]
[1, 2, 3, 4, 5, 10, 0, 8, 9, 7, 6, 11, 13, 14, 15, 12]
[1, 3, 4, 0, 5, 2, 6, 8, 9, 10, 7, 12, 13, 14, 11, 15]
[1, 2, 3, 4, 5, 6, 11, 7, 13, 9, 10, 8, 0, 14, 15, 12]
[1, 2, 3, 4, 5, 6, 12, 7, 9, 0, 10, 8, 13, 14, 11, 15]
[1, 0, 2, 4, 5, 7, 3, 8, 9, 6, 10, 11, 13, 14, 15, 12]
[1, 2, 7, 3, 5, 6, 11, 4, 9, 10, 15, 8, 13, 14, 0, 12]
[1, 2, 3, 4, 5, 10, 6, 7, 13, 9, 11, 8, 0, 14, 15, 12]
[5, 1, 2, 4, 0, 6, 3, 7, 9, 10, 11, 8, 13, 14, 15, 12]
[1, 3, 4, 0, 5, 2, 7, 8, 9, 6, 10, 11, 13, 14, 15, 12]
[1, 2, 3, 4, 5, 6, 8, 11, 9, 10, 7, 12, 13, 14, 0, 15]
[1, 2, 3, 4, 5, 10, 6, 8, 9, 14, 7, 12, 13, 11, 0, 15]
[5, 1, 2, 4, 0, 6, 3, 8, 9, 10, 7, 11, 13, 14, 15, 12]
[1, 2, 7, 0, 5, 6, 4, 3, 9, 10, 11, 8, 13, 14, 15, 12]
[1, 6, 2, 4, 5, 3, 0, 8, 9, 10, 7, 12, 13, 14, 11, 15]
[1, 2, 3, 4, 5, 6, 7, 8, 9, 0, 10, 15, 13, 14, 12, 11]
[1, 2, 3, 4, 5, 6, 11, 7, 9, 0, 15, 8, 13, 10, 14, 12]
[1, 0, 2, 3, 5, 6, 8, 4, 9, 10, 7, 12, 13, 14, 11, 15]
[1, 0, 3, 4, 6, 2, 7, 8, 5, 9, 10, 11, 13, 14, 15, 12]
[1, 2, 3, 4, 5, 6, 0, 8, 9, 14, 7, 11, 13, 15, 10, 12]
[1, 2, 3, 4, 5, 6, 11, 7, 9, 10, 15, 8, 0, 13, 14, 12]
[1, 2, 3, 4, 5, 6, 7, 8, 9, 10, 15, 0, 13, 14, 12, 11]
[1, 3, 6, 4, 5, 2, 0, 7, 9, 10, 11, 8, 13, 14, 15, 12]
[1, 2, 3, 4, 5, 6, 8, 11, 9, 0, 10, 7, 13, 14, 15, 12]
[1, 2, 3, 4, 5, 6, 0, 7, 9, 10, 15, 8, 13, 14, 12, 11]
[1, 0, 3, 4, 6, 2, 7, 8, 5, 9, 11, 12, 13, 10, 14, 15]
[1, 0, 2, 4, 5, 7, 3, 8, 9, 6, 10, 12, 13, 14, 11, 15]
[2, 0, 3, 4, 1, 6, 7, 8, 5, 9, 10, 11, 13, 14, 15, 12]
[1, 2, 3, 4, 5, 6, 0, 11, 9, 10, 8, 7, 13, 14, 15, 12]
[1, 2, 3, 4, 0, 6, 11, 7, 5, 9, 10, 8, 13, 14, 15, 12]
[1, 2, 3, 4, 5, 6, 0, 7, 9, 11, 12, 8, 13, 10, 14, 15]
[1, 2, 3, 4, 0, 5, 6, 8, 9, 11, 7, 12, 13, 10, 14, 15]
[1, 2, 3, 4, 5, 10, 6, 8, 9, 7, 15, 11, 13, 14, 0, 12]
[1, 2, 3, 4, 5, 7, 10, 8, 9, 6, 15, 11, 13, 14, 0, 12]
[1, 0, 7, 3, 5, 2, 6, 4, 9, 10, 11, 8, 13, 14, 15, 12]
[1, 6, 2, 4, 0, 5, 3, 7, 9, 10, 11, 8, 13, 14, 15, 12]
[1, 3, 4, 0, 5, 2, 7, 8, 9, 6, 11, 12, 13, 10, 14, 15]
[1, 2, 7, 3, 5, 6, 4, 8, 9, 10, 11, 0, 13, 14, 15, 12]
[1, 2, 3, 4, 6, 7, 0, 8, 5, 9, 10, 11, 13, 14, 15, 12]
[1, 2, 3, 4, 9, 5, 7, 8, 6, 0, 11, 12, 13, 10, 14, 15]
[1, 2, 3, 4, 5, 6, 8, 11, 9, 10, 15, 7, 13, 14, 0, 12]
[1, 2, 3, 4, 5, 6, 0, 8, 10, 11, 7, 12, 9, 13, 14, 15]
[1, 2, 3, 4, 0, 6, 7, 8, 5, 9, 15, 11, 13, 10, 14, 12]
[1, 0, 3, 4, 5, 2, 7, 8, 10, 6, 11, 12, 9, 13, 14, 15]
[1, 2, 3, 4, 9, 5, 6, 8, 10, 0, 7, 11, 13, 14, 15, 12]
[1, 2, 7, 3, 5, 10, 6, 4, 9, 0, 11, 8, 13, 14, 15, 12]
[1, 2, 3, 0, 5, 6, 7, 4, 9, 11, 12, 8, 13, 10, 14, 15]
[1, 2, 3, 4, 5, 10, 6, 8, 9, 14, 7, 12, 0, 13, 11, 15]
[1, 0, 2, 3, 5, 6, 7, 4, 9, 10, 12, 8, 13, 14, 11, 15]
[1, 2, 3, 4, 5, 6, 7, 8, 13, 0, 10, 12, 14, 9, 11, 15]
[1, 2, 3, 4, 5, 6, 7, 8, 13, 0, 10, 11, 14, 9, 15, 12]
[1, 2, 4, 0, 5, 7, 3, 8, 9, 6, 10, 11, 13, 14, 15, 12]
[1, 2, 3, 4, 9, 5, 6, 7, 13, 10, 11, 8, 0, 14, 15, 12]
[1, 2, 4, 7, 5, 6, 3, 8, 9, 10, 11, 0, 13, 14, 15, 12]
[1, 2, 3, 4, 9, 5, 6, 8, 13, 10, 7, 11, 0, 14, 15, 12]
[2, 0, 3, 4, 1, 5, 7, 8, 9, 6, 10, 11, 13, 14, 15, 12]
[1, 2, 3, 4, 5, 6, 7, 8, 9, 14, 10, 0, 13, 15, 12, 11]
[1, 2, 3, 4, 5, 7, 0, 8, 9, 6, 15, 11, 13, 10, 14, 12]
[1, 6, 2, 3, 5, 10, 7, 4, 9, 0, 11, 8, 13, 14, 15, 12]
[5, 1, 3, 4, 0, 2, 6, 8, 9, 10, 7, 11, 13, 14, 15, 12]
[1, 2, 3, 4, 5, 6, 7, 8, 14, 0, 10, 11, 9, 13, 15, 12]
[1, 2, 3, 4, 6, 7, 0, 8, 5, 9, 11, 12, 13, 10, 14, 15]
[1, 2, 3, 4, 5, 7, 10, 8, 9, 6, 12, 0, 13, 14, 11, 15]
[1, 2, 3, 4, 0, 6, 7, 8, 5, 14, 10, 12, 9, 13, 11, 15]
[1, 3, 4, 0, 5, 2, 6, 8, 9, 10, 7, 11, 13, 14, 15, 12]
[1, 2, 3, 0, 5, 6, 11, 4, 9, 10, 8, 7, 13, 14, 15, 12]
[5, 1, 3, 4, 0, 2, 6, 8, 9, 10, 7, 12, 13, 14, 11, 15]
[1, 2, 3, 4, 5, 6, 8, 12, 9, 10, 11, 7, 13, 14, 0, 15]
[1, 2, 3, 4, 5, 6, 7, 8, 13, 0, 11, 12, 10, 9, 14, 15]
[1, 2, 3, 4, 5, 7, 8, 12, 9, 6, 11, 0, 13, 10, 14, 15]
[1, 3, 7, 4, 5, 2, 0, 8, 9, 6, 11, 12, 13, 10, 14, 15]
[1, 2, 3, 4, 6, 10, 7, 8, 5, 0, 11, 12, 9, 13, 14, 15]
