[1, 2, 3, 4, 5, 6, 7, 8, 9, 0, 11, 12, 13, 10, 14, 15]
[1, 2, 3, 4, 5, 6, 0, 8, 9, 10, 7, 11, 13, 14, 15, 12]
[1, 2, 3, 4, 5, 6, 7, 8, 9, 10, 12, 0, 13, 14, 11, 15]
[1, 2, 3, 4, 5, 6, 7, 8, 9, 10, 15, 11, 13, 14, 0, 12]
[1, 2, 3, 4, 5, 6, 0, 7, 9, 10, 11, 8, 13, 14, 15, 12]
[1, 2, 3, 0, 5, 6, 7, 4, 9, 10, 11, 8, 13, 14, 15, 12]
[1, 2, 3, 4, 5, 6, 7, 8, 9, 10, 11, 12, 0, 13, 14, 15]
[1, 2, 3, 4, 5, 6, 0, 8, 9, 10, 7, 12, 13, 14, 11, 15]
[1, 2, 3, 4, 5, 6, 7, 8, 9, 0, 10, 12, 13, 14, 11, 15]
[1, 2, 3, 4, 5, 6, 7, 8, 9, 0, 10, 11, 13, 14, 15, 12]
