[1, 6, 2, 3, 9, 11, 5, 0, 10, 7, 15, 4, 13, 14, 12, 8]
[5, 1, 4, 7, 6, 10, 2, 0, 9, 14, 3, 11, 13, 15, 12, 8]
[1, 2, 3, 4, 5, 10, 12, 6, 13, 9, 11, 7, 14, 0, 8, 15]
[1, 6, 0, 4, 5, 7, 11, 2, 9, 10, 15, 3, 13, 14, 12, 8]
[10, 2, 3, 4, 6, 7, 11, 8, 1, 5, 0, 12, 9, 13, 14, 15]
[1, 3, 7, 4, 6, 2, 10, 8, 5, 13, 11, 12, 14, 0, 9, 15]
[5, 1, 2, 3, 8, 0, 4, 12, 6, 9, 10, 7, 13, 14, 11, 15]
[2, 3, 4, 8, 1, 6, 7, 12, 5, 9, 15, 14, 13, 10, 11, 0]
[1, 6, 2, 3, 5, 10, 7, 4, 9, 11, 8, 12, 13, 14, 15, 0]
[0, 2, 3, 4, 1, 13, 7, 8, 5, 6, 10, 11, 9, 14, 15, 12]
[2, 6, 3, 4, 1, 7, 8, 12, 5, 11, 10, 15, 13, 9, 14, 0]
[0, 2, 5, 3, 1, 10, 6, 4, 9, 12, 8, 7, 13, 14, 11, 15]
[1, 3, 4, 8, 5, 2, 7, 15, 10, 6, 14, 12, 9, 0, 13, 11]
[1, 2, 10, 4, 5, 6, 3, 7, 0, 14, 11, 8, 9, 13, 15, 12]
[5, 1, 2, 3, 9, 8, 11, 7, 10, 6, 0, 4, 13, 14, 15, 12]
[1, 2, 0, 7, 10, 6, 4, 8, 5, 9, 3, 11, 13, 14, 15, 12]
[5, 1, 2, 3, 9, 6, 7, 4, 14, 11, 15, 8, 10, 13, 12, 0]
[5, 1, 2, 4, 14, 6, 3, 8, 10, 7, 15, 11, 9, 13, 12, 0]
[1, 2, 4, 7, 5, 0, 6, 3, 9, 10, 12, 8, 13, 14, 11, 15]
[1, 2, 3, 4, 5, 6, 8, 11, 0, 9, 7, 12, 13, 10, 14, 15]
[1, 7, 2, 4, 5, 10, 6, 8, 9, 3, 0, 15, 13, 14, 12, 11]
[6, 2, 3, 4, 1, 5, 8, 11, 9, 10, 0, 12, 13, 14, 7, 15]
[1, 6, 2, 7, 5, 10, 4, 8, 9, 14, 0, 3, 13, 15, 12, 11]
[1, 2, 3, 4, 5, 9, 7, 0, 13, 6, 11, 8, 14, 10, 15, 12]
[1, 2, 7, 3, 9, 5, 6, 4, 13, 12, 8, 15, 10, 11, 14, 0]
[1, 2, 4, 12, 5, 6, 8, 3, 9, 10, 7, 15, 13, 14, 11, 0]
[2, 3, 0, 4, 1, 6, 12, 8, 5, 9, 7, 15, 13, 10, 11, 14]
[1, 2, 3, 4, 5, 6, 11, 7, 13, 9, 8, 12, 10, 0, 14, 15]
[6, 2, 8, 3, 1, 0, 5, 4, 9, 11, 7, 12, 13, 10, 14, 15]
[6, 3, 0, 4, 2, 13, 7, 8, 1, 5, 11, 12, 10, 9, 14, 15]
[1, 2, 4, 8, 5, 7, 10, 3, 14, 6, 0, 11, 9, 13, 15, 12]
[1, 7, 6, 3, 10, 14, 2, 4, 5, 13, 11, 8, 9, 0, 15, 12]
[1, 2, 3, 4, 9, 5, 8, 0, 10, 7, 6, 15, 13, 14, 12, 11]
[2, 3, 4, 8, 1, 5, 7, 11, 10, 6, 15, 12, 9, 0, 13, 14]
[2, 5, 3, 4, 1, 0, 6, 8, 10, 11, 7, 12, 9, 13, 14, 15]
[5, 1, 2, 3, 9, 0, 7, 4, 10, 6, 11, 8, 13, 14, 15, 12]
[1, 2, 3, 4, 10, 9, 6, 7, 0, 11, 14, 8, 5, 13, 12, 15]
[5, 1, 2, 8, 6, 10, 4, 3, 0, 13, 7, 11, 14, 9, 15, 12]
[1, 2, 4, 8, 5, 10, 6, 3, 9, 11, 12, 15, 13, 7, 14, 0]
[1, 2, 4, 7, 5, 6, 3, 8, 10, 13, 0, 11, 9, 14, 15, 12]
[1, 6, 8, 3, 9, 4, 2, 0, 10, 5, 7, 11, 13, 14, 15, 12]
[3, 4, 0, 8, 1, 6, 2, 12, 5, 10, 7, 11, 9, 13, 14, 15]
[2, 5, 3, 4, 1, 6, 11, 7, 13, 9, 10, 8, 14, 0, 15, 12]
[1, 2, 8, 3, 5, 7, 4, 0, 9, 6, 14, 11, 13, 15, 10, 12]
[5, 1, 2, 3, 6, 7, 4, 0, 13, 9, 12, 8, 14, 11, 10, 15]
[1, 2, 0, 4, 10, 6, 3, 7, 5, 9, 11, 8, 13, 14, 15, 12]
[2, 3, 8, 7, 1, 0, 6, 4, 5, 10, 15, 11, 9, 13, 14, 12]
[1, 8, 7, 6, 5, 2, 11, 3, 9, 10, 0, 4, 13, 14, 15, 12]
[0, 3, 4, 8, 1, 5, 6, 12, 9, 2, 7, 15, 13, 11, 10, 14]
[1, 2, 0, 5, 6, 3, 8, 4, 9, 10, 7, 11, 13, 14, 15, 12]
[1, 2, 3, 4, 6, 10, 8, 15, 0, 5, 7, 11, 9, 13, 14, 12]
[1, 2, 3, 4, 5, 6, 8, 0, 9, 10, 12, 15, 13, 14, 11, 7]
[0, 5, 1, 3, 2, 6, 7, 4, 9, 10, 15, 8, 13, 14, 12, 11]
[0, 5, 3, 4, 10, 1, 7, 8, 13, 2, 11, 12, 6, 9, 14, 15]
[1, 6, 4, 11, 5, 3, 8, 2, 0, 9, 10, 7, 13, 14, 15, 12]
[2, 6, 0, 3, 1, 7, 8, 4, 5, 9, 12, 15, 13, 10, 14, 11]
[5, 1, 4, 7, 9, 2, 3, 8, 0, 14, 10, 11, 6, 13, 15, 12]
[2, 6, 3, 7, 1, 9, 8, 4, 5, 14, 10, 11, 13, 15, 12, 0]
[2, 3, 4, 8, 1, 0, 5, 12, 9, 7, 10, 6, 13, 14, 11, 15]
[0, 1, 3, 4, 5, 2, 7, 8, 9, 6, 15, 11, 13, 10, 14, 12]
[2, 3, 4, 8, 1, 9, 11, 7, 13, 5, 0, 12, 10, 6, 14, 15]
[5, 1, 2, 3, 6, 8, 4, 0, 9, 10, 15, 11, 13, 14, 12, 7]
[1, 2, 3, 4, 5, 10, 11, 6, 13, 14, 0, 7, 15, 9, 12, 8]
[1, 6, 2, 7, 5, 0, 4, 3, 13, 9, 11, 8, 14, 15, 10, 12]
[0, 2, 3, 4, 1, 7, 14, 11, 5, 6, 15, 8, 9, 13, 10, 12]
[1, 2, 3, 4, 5, 10, 7, 8, 13, 15, 9, 12, 14, 0, 6, 11]
[1, 2, 8, 3, 5, 6, 7, 4, 0, 10, 12, 15, 9, 13, 14, 11]
[6, 1, 3, 4, 5, 2, 7, 8, 0, 11, 9, 12, 13, 14, 10, 15]
[1, 2, 3, 4, 10, 5, 6, 8, 0, 13, 11, 12, 9, 7, 14, 15]
[2, 7, 3, 4, 1, 6, 11, 8, 5, 10, 0, 15, 9, 13, 14, 12]
[5, 1, 2, 3, 6, 7, 12, 4, 9, 10, 0, 8, 13, 14, 11, 15]
[5, 1, 2, 3, 10, 9, 7, 11, 0, 6, 8, 4, 13, 14, 15, 12]
[1, 2, 3, 4, 14, 11, 10, 7, 6, 5, 15, 8, 9, 0, 13, 12]
[5, 1, 3, 4, 9, 0, 2, 8, 13, 11, 7, 14, 10, 6, 15, 12]
[1, 2, 4, 8, 9, 5, 3, 12, 6, 14, 10, 11, 13, 0, 15, 7]
[5, 2, 4, 7, 6, 0, 1, 3, 9, 10, 11, 8, 13, 14, 15, 12]
[1, 2, 0, 4, 6, 7, 3, 8, 5, 10, 14, 12, 9, 11, 13, 15]
[2, 3, 7, 4, 1, 6, 11, 8, 5, 9, 0, 12, 10, 14, 13, 15]
[0, 6, 2, 4, 1, 5, 3, 8, 9, 10, 15, 11, 13, 14, 12, 7]
[1, 2, 7, 3, 5, 11, 4, 12, 10, 6, 8, 15, 9, 13, 14, 0]
[1, 2, 0, 8, 5, 6, 4, 3, 13, 14, 7, 12, 10, 11, 9, 15]
[2, 7, 3, 4, 1, 0, 15, 8, 5, 9, 11, 12, 13, 6, 10, 14]
[5, 1, 2, 8, 6, 0, 4, 3, 9, 14, 7, 12, 10, 13, 11, 15]
[2, 3, 6, 4, 1, 10, 5, 7, 9, 11, 0, 12, 13, 14, 8, 15]
[1, 3, 4, 8, 6, 9, 2, 7, 0, 11, 14, 12, 5, 13, 10, 15]
[5, 6, 1, 2, 9, 0, 7, 3, 10, 14, 11, 4, 13, 15, 12, 8]
[1, 2, 0, 4, 9, 10, 3, 6, 13, 7, 5, 8, 14, 11, 15, 12]
[1, 6, 2, 4, 5, 3, 11, 7, 13, 9, 10, 15, 14, 12, 8, 0]
[2, 3, 7, 4, 1, 6, 8, 15, 5, 10, 0, 12, 9, 13, 14, 11]
[1, 2, 3, 4, 6, 7, 8, 11, 5, 15, 0, 12, 13, 9, 10, 14]
[1, 3, 6, 7, 5, 4, 11, 2, 9, 14, 10, 8, 13, 0, 15, 12]
[2, 3, 0, 4, 1, 6, 7, 8, 5, 11, 15, 14, 9, 13, 10, 12]
[5, 1, 3, 4, 10, 6, 11, 7, 2, 9, 15, 8, 13, 0, 14, 12]
[0, 2, 6, 8, 1, 5, 10, 3, 9, 7, 12, 4, 13, 14, 11, 15]
[1, 2, 7, 3, 5, 0, 6, 4, 9, 10, 11, 8, 13, 12, 14, 15]
[2, 3, 7, 4, 6, 0, 15, 8, 1, 5, 14, 11, 13, 9, 10, 12]
[6, 5, 2, 4, 1, 0, 3, 12, 9, 10, 8, 15, 13, 14, 7, 11]
[1, 2, 0, 7, 5, 6, 11, 3, 9, 10, 15, 4, 13, 14, 12, 8]
[0, 1, 6, 2, 5, 11, 3, 7, 9, 10, 8, 4, 13, 14, 15, 12]
[5, 1, 2, 3, 10, 6, 7, 4, 13, 14, 11, 8, 9, 0, 15, 12]
[0, 1, 3, 4, 6, 2, 14, 8, 5, 10, 7, 11, 9, 13, 15, 12]
[1, 6, 2, 3, 5, 0, 7, 4, 9, 12, 11, 15, 13, 10, 14, 8]
[1, 3, 6, 4, 5, 9, 7, 8, 10, 2, 11, 12, 13, 14, 15, 0]
[5, 1, 3, 4, 9, 0, 7, 8, 10, 6, 2, 11, 13, 14, 15, 12]
[1, 7, 2, 3, 5, 0, 4, 6, 9, 10, 11, 8, 13, 14, 15, 12]
[5, 1, 3, 4, 9, 2, 7, 8, 15, 14, 0, 11, 6, 13, 10, 12]
[5, 1, 3, 4, 2, 0, 8, 12, 9, 7, 6, 11, 13, 14, 15, 10]
[1, 2, 6, 4, 5, 10, 7, 0, 9, 14, 11, 3, 13, 15, 12, 8]
[2, 3, 4, 8, 5, 1, 6, 7, 10, 13, 15, 11, 9, 0, 14, 12]
[1, 2, 3, 4, 5, 6, 7, 8, 9, 10, 12, 15, 13, 14, 11, 0]
[1, 6, 3, 4, 5, 0, 10, 2, 9, 14, 8, 11, 13, 15, 7, 12]
[1, 6, 2, 4, 10, 14, 8, 11, 5, 7, 0, 3, 9, 13, 15, 12]
[6, 5, 11, 2, 1, 3, 8, 4, 9, 10, 0, 7, 13, 14, 15, 12]
[1, 2, 3, 4, 5, 6, 8, 12, 9, 10, 7, 15, 11, 13, 14, 0]
[2, 3, 7, 4, 1, 6, 12, 8, 5, 14, 0, 10, 9, 13, 15, 11]
[1, 2, 8, 4, 5, 0, 3, 7, 9, 6, 15, 11, 13, 10, 14, 12]
[0, 5, 1, 2, 10, 7, 4, 3, 6, 9, 11, 8, 13, 14, 15, 12]
[5, 1, 0, 4, 2, 7, 3, 8, 9, 6, 10, 11, 13, 14, 15, 12]
[5, 1, 0, 3, 9, 7, 2, 4, 13, 6, 15, 8, 14, 11, 10, 12]
[1, 2, 4, 11, 5, 10, 3, 12, 9, 8, 6, 15, 13, 14, 7, 0]
