[1, 2, 7, 3, 5, 6, 4, 8, 0, 9, 10, 11, 13, 14, 15, 12]
[0, 1, 2, 4, 6, 7, 3, 8, 5, 10, 11, 12, 9, 13, 14, 15]
[1, 2, 3, 4, 5, 6, 7, 8, 14, 13, 10, 11, 9, 15, 12, 0]
[5, 1, 2, 4, 9, 6, 3, 7, 10, 11, 0, 8, 13, 14, 15, 12]
[1, 2, 3, 4, 10, 0, 6, 8, 5, 14, 7, 12, 9, 13, 11, 15]
[1, 3, 7, 4, 5, 0, 2, 8, 10, 6, 11, 12, 9, 13, 14, 15]
[1, 6, 2, 3, 5, 7, 11, 4, 9, 10, 8, 12, 13, 14, 15, 0]
[5, 1, 2, 4, 6, 10, 3, 8, 9, 14, 7, 11, 13, 0, 15, 12]
[1, 2, 3, 4, 5, 6, 7, 8, 13, 11, 12, 15, 10, 9, 14, 0]
[0, 2, 3, 4, 1, 6, 7, 8, 5, 13, 10, 11, 14, 9, 15, 12]
[1, 2, 3, 4, 5, 6, 7, 8, 9, 15, 0, 12, 13, 10, 11, 14]
[0, 2, 3, 4, 1, 6, 7, 8, 5, 9, 12, 15, 13, 10, 14, 11]
[2, 5, 3, 4, 1, 0, 6, 8, 9, 11, 7, 12, 13, 10, 14, 15]
[1, 2, 3, 4, 6, 10, 7, 8, 5, 15, 0, 11, 9, 13, 14, 12]
[1, 2, 3, 4, 5, 6, 7, 8, 14, 10, 15, 11, 9, 13, 12, 0]
[1, 2, 3, 4, 5, 6, 8, 12, 9, 11, 14, 7, 13, 10, 15, 0]
[1, 2, 3, 4, 9, 5, 7, 8, 13, 10, 0, 11, 14, 6, 15, 12]
[1, 2, 4, 8, 5, 7, 3, 11, 9, 6, 10, 12, 13, 14, 15, 0]
[2, 3, 7, 4, 1, 5, 8, 0, 9, 6, 10, 12, 13, 14, 11, 15]
[1, 2, 3, 4, 5, 6, 7, 8, 10, 15, 11, 12, 9, 13, 14, 0]
[1, 2, 3, 4, 5, 7, 10, 8, 13, 6, 0, 12, 14, 9, 11, 15]
[6, 2, 0, 4, 1, 5, 3, 8, 9, 10, 7, 11, 13, 14, 15, 12]
[2, 3, 4, 8, 1, 5, 6, 0, 9, 10, 7, 12, 13, 14, 11, 15]
[1, 6, 2, 4, 5, 10, 3, 8, 13, 9, 7, 12, 14, 0, 11, 15]
[0, 1, 2, 4, 5, 6, 3, 7, 9, 10, 15, 8, 13, 14, 12, 11]
[1, 2, 7, 3, 5, 6, 11, 4, 9, 10, 0, 12, 13, 14, 8, 15]
[5, 1, 2, 3, 9, 0, 7, 4, 10, 6, 11, 8, 13, 14, 15, 12]
[1, 2, 3, 4, 5, 6, 8, 0, 9, 10, 15, 11, 13, 14, 12, 7]
[1, 2, 3, 4, 6, 10, 7, 8, 5, 11, 14, 12, 9, 13, 15, 0]
[1, 2, 3, 4, 5, 6, 7, 8, 13, 10, 15, 11, 14, 9, 12, 0]
[1, 2, 3, 4, 5, 6, 11, 7, 9, 10, 12, 15, 13, 14, 8, 0]
[5, 1, 7, 3, 9, 2, 6, 4, 0, 10, 11, 8, 13, 14, 15, 12]
[5, 1, 2, 4, 9, 6, 3, 7, 13, 10, 11, 8, 14, 0, 15, 12]
[1, 2, 11, 3, 5, 6, 4, 0, 9, 10, 8, 7, 13, 14, 15, 12]
[1, 2, 3, 4, 5, 6, 11, 0, 9, 10, 8, 12, 13, 14, 7, 15]
[1, 2, 3, 4, 5, 6, 7, 8, 9, 12, 14, 15, 13, 10, 11, 0]
[1, 3, 7, 4, 5, 2, 11, 8, 9, 6, 12, 15, 13, 10, 14, 0]
[1, 7, 6, 3, 5, 0, 2, 4, 9, 10, 11, 8, 13, 14, 15, 12]
[1, 3, 6, 4, 5, 2, 11, 0, 9, 10, 8, 7, 13, 14, 15, 12]
[1, 2, 7, 3, 5, 6, 11, 4, 9, 10, 8, 12, 13, 0, 14, 15]
[2, 6, 3, 4, 1, 7, 8, 0, 5, 10, 11, 12, 9, 13, 14, 15]
[1, 2, 3, 4, 5, 6, 11, 7, 10, 13, 15, 8, 9, 0, 14, 12]
[1, 2, 3, 4, 5, 6, 7, 8, 9, 15, 14, 10, 13, 0, 12, 11]
[5, 1, 2, 4, 6, 3, 7, 8, 9, 10, 0, 12, 13, 14, 11, 15]
[1, 3, 6, 4, 5, 10, 2, 7, 9, 11, 0, 8, 13, 14, 15, 12]
[0, 6, 3, 4, 2, 1, 7, 8, 5, 10, 11, 12, 9, 13, 14, 15]
[1, 2, 3, 4, 5, 6, 7, 8, 10, 11, 12, 15, 9, 0, 13, 14]
[1, 6, 3, 4, 5, 7, 2, 0, 9, 10, 11, 8, 13, 14, 15, 12]
[1, 2, 3, 4, 6, 0, 7, 8, 5, 10, 12, 15, 9, 13, 14, 11]
[0, 5, 2, 3, 6, 1, 7, 4, 9, 10, 11, 8, 13, 14, 15, 12]
[1, 3, 7, 4, 5, 2, 11, 8, 9, 10, 6, 12, 13, 0, 14, 15]
[1, 2, 3, 4, 5, 6, 8, 0, 14, 10, 7, 11, 9, 13, 15, 12]
[2, 3, 7, 4, 1, 6, 8, 0, 5, 9, 11, 12, 13, 10, 14, 15]
[5, 3, 0, 4, 2, 1, 6, 8, 9, 10, 7, 11, 13, 14, 15, 12]
[0, 1, 2, 3, 5, 6, 7, 4, 9, 10, 15, 8, 13, 14, 12, 11]
[1, 6, 2, 3, 5, 0, 7, 4, 9, 10, 15, 8, 13, 14, 12, 11]
[5, 1, 2, 3, 9, 6, 7, 4, 10, 11, 0, 8, 13, 14, 15, 12]
[1, 3, 7, 4, 6, 2, 11, 8, 5, 9, 0, 12, 13, 10, 14, 15]
[1, 2, 3, 4, 5, 6, 7, 8, 13, 9, 0, 10, 14, 11, 15, 12]
[2, 3, 7, 4, 1, 6, 11, 8, 5, 9, 0, 12, 13, 10, 14, 15]
[5, 1, 2, 3, 9, 6, 7, 4, 13, 10, 11, 8, 14, 0, 15, 12]
[1, 2, 3, 4, 9, 5, 6, 7, 13, 10, 12, 8, 14, 0, 11, 15]
[1, 2, 3, 4, 5, 6, 7, 8, 13, 9, 0, 10, 14, 15, 12, 11]
[5, 1, 2, 4, 9, 7, 3, 8, 0, 6, 11, 12, 13, 10, 14, 15]
[1, 2, 4, 8, 5, 6, 7, 0, 9, 10, 11, 3, 13, 14, 15, 12]
[1, 6, 2, 3, 5, 10, 7, 4, 9, 11, 8, 12, 13, 14, 15, 0]
[1, 2, 3, 4, 5, 0, 7, 12, 9, 6, 8, 10, 13, 14, 11, 15]
[0, 1, 3, 4, 9, 2, 7, 8, 6, 5, 11, 12, 13, 10, 14, 15]
[0, 1, 6, 3, 5, 7, 2, 4, 9, 10, 11, 8, 13, 14, 15, 12]
[1, 2, 3, 4, 5, 6, 7, 8, 0, 14, 10, 15, 9, 13, 12, 11]
[1, 2, 3, 4, 5, 6, 11, 7, 9, 14, 10, 12, 13, 0, 8, 15]
[2, 3, 6, 4, 1, 5, 7, 8, 9, 10, 0, 12, 13, 14, 11, 15]
[5, 1, 2, 3, 6, 10, 7, 4, 9, 11, 0, 8, 13, 14, 15, 12]
[1, 3, 7, 4, 6, 2, 8, 0, 5, 10, 11, 12, 9, 13, 14, 15]
[6, 2, 0, 4, 1, 5, 3, 7, 9, 10, 11, 8, 13, 14, 15, 12]
[2, 3, 4, 8, 1, 6, 7, 0, 5, 9, 11, 12, 13, 10, 14, 15]
[5, 1, 3, 4, 10, 2, 7, 8, 0, 6, 11, 12, 9, 13, 14, 15]
[5, 1, 2, 3, 6, 0, 8, 4, 9, 10, 7, 12, 13, 14, 11, 15]
[2, 3, 7, 4, 1, 0, 5, 8, 9, 6, 11, 12, 13, 10, 14, 15]
[1, 6, 0, 3, 5, 10, 2, 4, 9, 11, 7, 8, 13, 14, 15, 12]
[1, 2, 0, 3, 5, 6, 7, 4, 9, 14, 11, 8, 13, 15, 10, 12]
[1, 2, 3, 4, 5, 0, 11, 7, 14, 6, 10, 8, 9, 13, 15, 12]
[6, 1, 3, 4, 5, 2, 7, 8, 0, 10, 11, 12, 9, 13, 14, 15]
[1, 2, 0, 4, 6, 7, 3, 8, 5, 14, 10, 12, 9, 13, 11, 15]
[5, 1, 3, 4, 9, 2, 7, 8, 13, 6, 10, 12, 14, 0, 11, 15]
[2, 3, 0, 4, 1, 10, 6, 8, 5, 9, 7, 11, 13, 14, 15, 12]
[1, 2, 3, 4, 5, 6, 8, 0, 9, 12, 7, 15, 13, 10, 14, 11]
[1, 2, 3, 4, 5, 6, 7, 8, 9, 14, 0, 15, 13, 11, 12, 10]
[5, 1, 2, 3, 9, 6, 8, 4, 0, 10, 7, 12, 13, 14, 11, 15]
[1, 2, 3, 4, 6, 9, 11, 7, 5, 10, 0, 8, 13, 14, 15, 12]
[1, 2, 3, 4, 6, 14, 7, 8, 0, 5, 10, 11, 9, 13, 15, 12]
[1, 3, 4, 8, 5, 2, 7, 0, 10, 6, 11, 12, 9, 13, 14, 15]
[1, 2, 7, 3, 5, 6, 12, 4, 9, 10, 11, 8, 13, 14, 15, 0]
[1, 2, 7, 3, 5, 6, 4, 8, 9, 10, 11, 12, 13, 0, 14, 15]
[1, 2, 4, 7, 5, 6, 3, 8, 9, 10, 12, 15, 13, 14, 11, 0]
[1, 6, 2, 3, 5, 0, 10, 4, 9, 11, 7, 8, 13, 14, 15, 12]
[1, 6, 2, 4, 5, 3, 7, 0, 9, 10, 12, 8, 13, 14, 11, 15]
[1, 2, 3, 4, 9, 5, 6, 11, 0, 10, 8, 7, 13, 14, 15, 12]
[1, 2, 3, 4, 5, 7, 11, 8, 13, 9, 6, 12, 10, 0, 14, 15]
[1, 2, 3, 4, 5, 10, 6, 7, 9, 12, 11, 8, 13, 14, 15, 0]
[1, 2, 3, 4, 6, 7, 10, 8, 5, 9, 11, 12, 13, 14, 15, 0]
[1, 2, 0, 3, 5, 6, 7, 4, 10, 11, 12, 8, 9, 13, 14, 15]
[1, 3, 0, 8, 5, 2, 4, 6, 9, 10, 7, 11, 13, 14, 15, 12]
[1, 2, 3, 4, 5, 6, 11, 0, 9, 14, 10, 7, 13, 15, 12, 8]
[1, 2, 4, 8, 9, 5, 6, 3, 0, 10, 7, 12, 13, 14, 11, 15]
[1, 2, 8, 3, 5, 6, 7, 4, 9, 14, 10, 12, 13, 0, 11, 15]
[5, 1, 3, 4, 2, 7, 10, 8, 9, 6, 0, 11, 13, 14, 15, 12]
[5, 1, 2, 3, 6, 0, 8, 4, 9, 10, 7, 11, 13, 14, 15, 12]
[2, 3, 0, 4, 1, 10, 6, 8, 5, 9, 7, 12, 13, 14, 11, 15]
[2, 3, 4, 8, 1, 6, 7, 0, 5, 10, 11, 12, 9, 13, 14, 15]
[2, 6, 3, 4, 1, 0, 7, 8, 5, 10, 15, 11, 9, 13, 14, 12]
[1, 2, 4, 8, 5, 6, 3, 11, 9, 10, 0, 12, 13, 14, 7, 15]
[0, 1, 3, 4, 5, 2, 6, 7, 9, 11, 12, 8, 13, 10, 14, 15]
[0, 6, 3, 4, 2, 1, 7, 8, 5, 9, 11, 12, 13, 10, 14, 15]
[1, 2, 7, 3, 5, 6, 11, 4, 0, 10, 15, 8, 9, 13, 14, 12]
