[5, 1, 3, 4, 9, 2, 7, 8, 10, 13, 15, 11, 6, 14, 0, 12]
[2, 3, 4, 7, 1, 6, 0, 10, 5, 9, 15, 8, 13, 14, 11, 12]
[1, 2, 3, 4, 9, 6, 11, 8, 10, 7, 12, 15, 5, 13, 0, 14]
[2, 6, 3, 4, 0, 1, 11, 8, 5, 7, 9, 12, 13, 10, 14, 15]
[6, 1, 3, 4, 5, 2, 7, 8, 9, 13, 10, 12, 0, 11, 14, 15]
[2, 6, 3, 7, 1, 11, 10, 8, 5, 0, 14, 4, 9, 13, 15, 12]
[5, 1, 3, 4, 9, 6, 2, 8, 13, 7, 12, 0, 14, 11, 10, 15]
[6, 1, 2, 3, 0, 7, 12, 4, 10, 5, 13, 8, 9, 14, 11, 15]
[5, 1, 3, 4, 0, 13, 6, 11, 2, 9, 8, 7, 14, 10, 15, 12]
[1, 6, 2, 3, 5, 13, 7, 4, 9, 15, 8, 0, 14, 10, 12, 11]
[1, 6, 2, 4, 9, 13, 3, 7, 5, 0, 12, 8, 10, 14, 11, 15]
[5, 6, 1, 2, 0, 10, 7, 4, 9, 13, 3, 11, 14, 15, 12, 8]
[2, 3, 12, 4, 1, 6, 0, 7, 5, 9, 8, 15, 13, 10, 14, 11]
[13, 5, 3, 4, 6, 1, 7, 8, 9, 14, 10, 12, 0, 2, 11, 15]
[1, 10, 6, 2, 0, 5, 11, 3, 13, 9, 8, 4, 14, 15, 12, 7]
[2, 7, 6, 3, 5, 10, 0, 4, 14, 1, 12, 8, 9, 13, 11, 15]
[1, 2, 7, 0, 5, 6, 4, 3, 9, 14, 11, 8, 10, 13, 15, 12]
[6, 1, 2, 4, 7, 14, 0, 3, 5, 11, 12, 8, 9, 10, 13, 15]
[5, 1, 2, 4, 7, 10, 3, 8, 9, 0, 11, 14, 6, 13, 15, 12]
[9, 5, 2, 4, 13, 1, 0, 3, 6, 10, 7, 8, 14, 11, 15, 12]
[5, 3, 4, 8, 2, 6, 1, 11, 13, 9, 7, 0, 14, 15, 12, 10]
[5, 1, 4, 10, 14, 2, 7, 3, 6, 0, 11, 8, 9, 13, 15, 12]
[5, 1, 3, 4, 0, 2, 12, 8, 9, 6, 15, 10, 13, 14, 7, 11]
[5, 0, 1, 2, 6, 4, 3, 8, 9, 14, 7, 10, 13, 15, 12, 11]
[2, 3, 7, 12, 1, 6, 8, 15, 5, 9, 4, 0, 13, 10, 11, 14]
[9, 5, 2, 3, 1, 7, 0, 8, 10, 6, 4, 12, 13, 14, 11, 15]
[1, 10, 2, 3, 5, 9, 8, 4, 14, 7, 15, 11, 6, 13, 0, 12]
[1, 6, 2, 0, 9, 5, 15, 4, 10, 14, 11, 3, 13, 12, 8, 7]
[6, 1, 7, 3, 5, 2, 12, 4, 9, 10, 11, 0, 13, 14, 15, 8]
[6, 1, 3, 4, 5, 7, 0, 8, 15, 2, 14, 11, 13, 10, 9, 12]
[2, 0, 3, 4, 1, 5, 11, 8, 6, 7, 12, 15, 10, 9, 13, 14]
[5, 1, 4, 15, 6, 3, 0, 7, 9, 10, 2, 8, 13, 14, 12, 11]
[2, 0, 3, 4, 1, 6, 11, 7, 5, 14, 9, 8, 13, 10, 15, 12]
[3, 4, 7, 8, 2, 5, 12, 11, 1, 9, 6, 15, 13, 10, 0, 14]
[9, 1, 2, 4, 6, 3, 7, 8, 10, 5, 15, 11, 13, 14, 0, 12]
[1, 2, 4, 7, 5, 10, 6, 3, 9, 13, 15, 8, 14, 11, 0, 12]
[2, 7, 4, 11, 1, 12, 6, 3, 5, 9, 14, 8, 13, 10, 0, 15]
[5, 1, 2, 0, 6, 8, 11, 3, 9, 14, 4, 12, 13, 15, 7, 10]
[1, 3, 4, 0, 5, 2, 7, 8, 10, 6, 9, 11, 14, 13, 15, 12]
[5, 0, 3, 4, 2, 1, 6, 8, 14, 13, 7, 10, 9, 11, 15, 12]
[6, 2, 8, 4, 0, 1, 5, 11, 13, 3, 10, 7, 14, 9, 15, 12]
[2, 6, 3, 8, 0, 9, 4, 7, 1, 5, 11, 12, 13, 10, 14, 15]
[6, 1, 3, 4, 5, 7, 8, 15, 10, 2, 11, 0, 9, 13, 12, 14]
[1, 2, 3, 4, 5, 7, 8, 12, 9, 0, 11, 15, 13, 10, 14, 6]
[6, 1, 8, 3, 2, 7, 11, 4, 5, 13, 14, 0, 10, 9, 15, 12]
[2, 10, 3, 4, 1, 6, 8, 7, 5, 13, 14, 0, 15, 9, 12, 11]
[5, 3, 7, 4, 2, 6, 1, 8, 14, 0, 13, 10, 9, 15, 12, 11]
[7, 5, 2, 3, 1, 6, 0, 4, 13, 10, 8, 11, 14, 9, 15, 12]
[2, 5, 3, 4, 1, 7, 6, 8, 11, 0, 13, 12, 9, 14, 10, 15]
[6, 2, 4, 7, 1, 10, 3, 8, 5, 14, 12, 15, 0, 9, 13, 11]
[5, 0, 2, 3, 6, 9, 8, 4, 10, 1, 7, 12, 13, 14, 11, 15]
[7, 0, 2, 4, 5, 3, 1, 8, 10, 6, 15, 11, 9, 13, 14, 12]
[1, 2, 4, 8, 0, 11, 6, 3, 5, 7, 14, 12, 10, 9, 13, 15]
[2, 4, 8, 12, 1, 3, 5, 6, 9, 7, 10, 0, 13, 14, 11, 15]
[1, 0, 5, 8, 6, 2, 4, 12, 9, 10, 3, 7, 13, 14, 11, 15]
[1, 2, 7, 3, 0, 9, 11, 4, 6, 12, 14, 15, 5, 13, 10, 8]
[2, 8, 3, 4, 9, 1, 5, 7, 6, 10, 11, 12, 0, 13, 14, 15]
[5, 1, 2, 3, 9, 7, 0, 8, 11, 10, 12, 4, 13, 6, 14, 15]
[5, 1, 4, 2, 9, 7, 3, 8, 13, 0, 6, 12, 14, 10, 11, 15]
[2, 6, 3, 4, 1, 13, 8, 11, 5, 0, 10, 7, 14, 9, 15, 12]
[9, 3, 4, 0, 2, 1, 7, 8, 14, 5, 10, 11, 6, 13, 15, 12]
[5, 2, 7, 3, 9, 1, 4, 8, 13, 6, 11, 12, 14, 10, 0, 15]
[5, 1, 4, 7, 2, 11, 6, 8, 9, 0, 3, 12, 13, 10, 14, 15]
[1, 2, 4, 8, 0, 7, 15, 3, 6, 9, 10, 11, 13, 5, 14, 12]
[5, 1, 2, 4, 10, 14, 3, 7, 9, 11, 8, 12, 13, 6, 0, 15]
[2, 3, 11, 4, 1, 7, 0, 8, 6, 5, 13, 15, 10, 9, 12, 14]
[1, 0, 8, 3, 12, 2, 6, 4, 5, 10, 7, 15, 9, 13, 14, 11]
[5, 1, 3, 8, 0, 10, 4, 6, 2, 7, 15, 11, 9, 13, 14, 12]
[2, 6, 3, 4, 1, 9, 7, 8, 10, 0, 13, 15, 5, 14, 12, 11]
[5, 7, 1, 3, 9, 6, 2, 4, 13, 10, 14, 8, 15, 11, 0, 12]
[6, 2, 4, 7, 10, 5, 3, 8, 1, 11, 15, 0, 9, 13, 14, 12]
[1, 2, 8, 3, 0, 7, 14, 4, 5, 13, 10, 12, 6, 9, 11, 15]
[2, 7, 3, 4, 0, 1, 8, 12, 6, 13, 11, 15, 5, 10, 9, 14]
[1, 6, 3, 4, 9, 5, 7, 2, 10, 11, 12, 15, 0, 13, 14, 8]
[2, 0, 5, 3, 9, 1, 6, 4, 13, 10, 12, 7, 14, 11, 15, 8]
[1, 2, 3, 4, 7, 13, 8, 12, 5, 9, 6, 15, 10, 11, 0, 14]
[2, 7, 6, 3, 0, 1, 10, 4, 5, 13, 14, 8, 9, 11, 15, 12]
[2, 3, 7, 8, 1, 5, 4, 11, 9, 10, 6, 0, 13, 14, 15, 12]
[2, 7, 3, 11, 1, 10, 5, 6, 9, 14, 15, 4, 13, 12, 0, 8]
[1, 6, 4, 7, 10, 3, 2, 8, 5, 13, 15, 0, 14, 9, 12, 11]
[5, 1, 2, 3, 9, 6, 8, 4, 13, 7, 12, 15, 14, 10, 0, 11]
[1, 2, 7, 3, 5, 11, 10, 4, 6, 13, 15, 8, 0, 9, 14, 12]
[5, 6, 1, 4, 0, 13, 2, 7, 11, 9, 3, 8, 14, 10, 15, 12]
[3, 4, 8, 0, 1, 9, 7, 12, 2, 5, 6, 15, 13, 10, 11, 14]
[1, 6, 8, 12, 5, 4, 2, 15, 9, 0, 3, 11, 13, 10, 14, 7]
[5, 1, 3, 4, 0, 6, 10, 8, 7, 2, 11, 12, 9, 13, 14, 15]
[1, 7, 3, 4, 5, 2, 6, 8, 14, 10, 15, 0, 9, 13, 12, 11]
[1, 2, 4, 8, 5, 6, 3, 12, 7, 0, 14, 15, 13, 10, 9, 11]
[1, 2, 8, 3, 5, 6, 12, 7, 13, 9, 11, 14, 10, 15, 0, 4]
[2, 3, 1, 4, 5, 9, 0, 8, 13, 7, 10, 12, 14, 6, 11, 15]
[5, 2, 3, 4, 9, 1, 12, 7, 13, 0, 6, 11, 14, 10, 15, 8]
[1, 3, 6, 4, 10, 9, 12, 2, 5, 14, 7, 8, 13, 11, 0, 15]
[5, 1, 7, 3, 9, 2, 0, 4, 11, 10, 6, 14, 13, 15, 12, 8]
[5, 1, 6, 2, 9, 10, 8, 3, 13, 11, 4, 0, 14, 7, 15, 12]
[1, 10, 4, 8, 0, 5, 6, 3, 2, 9, 7, 11, 13, 14, 15, 12]
[1, 2, 7, 3, 10, 9, 6, 4, 5, 0, 12, 15, 13, 11, 14, 8]
[1, 2, 3, 4, 5, 6, 8, 10, 11, 13, 7, 0, 14, 9, 15, 12]
[1, 10, 6, 2, 13, 5, 3, 4, 9, 15, 7, 8, 14, 12, 0, 11]
[2, 0, 3, 4, 1, 11, 6, 8, 5, 7, 12, 15, 9, 13, 10, 14]
[5, 3, 4, 8, 2, 10, 1, 6, 9, 7, 15, 0, 13, 14, 12, 11]
[1, 4, 7, 3, 5, 2, 6, 8, 9, 10, 11, 12, 13, 14, 0, 15]
[2, 0, 4, 8, 1, 5, 3, 11, 9, 10, 6, 12, 13, 7, 14, 15]
[5, 1, 3, 4, 7, 11, 0, 2, 6, 9, 10, 15, 13, 14, 12, 8]
[1, 0, 2, 8, 5, 4, 11, 3, 10, 6, 7, 12, 9, 13, 14, 15]
[3, 4, 8, 7, 5, 2, 1, 6, 9, 10, 11, 12, 0, 13, 14, 15]
[1, 0, 2, 3, 5, 6, 7, 11, 13, 9, 10, 4, 14, 15, 12, 8]
[6, 2, 7, 3, 13, 1, 5, 4, 14, 10, 11, 8, 9, 15, 0, 12]
[5, 6, 3, 4, 9, 1, 0, 11, 10, 7, 8, 2, 13, 14, 15, 12]
[1, 2, 6, 0, 7, 8, 11, 3, 5, 10, 14, 4, 9, 13, 15, 12]
[1, 2, 3, 4, 5, 6, 0, 14, 10, 11, 8, 15, 9, 13, 12, 7]
[5, 1, 7, 3, 9, 2, 0, 15, 10, 11, 4, 8, 13, 14, 6, 12]
[2, 3, 4, 8, 0, 5, 11, 7, 1, 6, 14, 12, 9, 13, 10, 15]
[6, 0, 1, 7, 2, 10, 3, 4, 5, 9, 11, 8, 13, 14, 15, 12]
[1, 2, 4, 8, 5, 10, 6, 12, 13, 0, 9, 11, 14, 15, 3, 7]
[1, 2, 8, 3, 6, 7, 0, 4, 14, 15, 10, 11, 5, 9, 13, 12]
[3, 0, 4, 8, 2, 6, 7, 12, 1, 5, 15, 14, 9, 10, 13, 11]
[2, 7, 4, 0, 1, 8, 3, 15, 5, 6, 10, 11, 9, 13, 14, 12]
[5, 1, 4, 8, 0, 10, 6, 11, 2, 3, 7, 12, 9, 13, 14, 15]
[2, 3, 4, 8, 1, 10, 0, 7, 5, 6, 9, 15, 13, 14, 12, 11]
[2, 6, 3, 4, 5, 1, 8, 15, 9, 0, 12, 7, 13, 10, 14, 11]
