[1, 2, 3, 4, 6, 0, 7, 8, 5, 9, 10, 11, 13, 14, 15, 12]
[1, 2, 0, 4, 5, 7, 3, 8, 9, 6, 11, 12, 13, 10, 14, 15]
[1, 6, 2, 4, 5, 0, 3, 7, 9, 10, 11, 8, 13, 14, 15, 12]
[1, 2, 3, 4, 5, 6, 7, 8, 9, 15, 0, 11, 13, 10, 14, 12]
[1, 2, 3, 4, 5, 6, 7, 8, 0, 14, 10, 11, 9, 13, 15, 12]
[1, 2, 3, 4, 5, 6, 7, 8, 9, 10, 15, 11, 13, 14, 12, 0]
[1, 2, 3, 4, 5, 6, 7, 8, 9, 10, 12, 15, 13, 14, 11, 0]
[1, 6, 2, 3, 5, 0, 7, 4, 9, 10, 11, 8, 13, 14, 15, 12]
[0, 1, 2, 3, 5, 6, 7, 4, 9, 10, 11, 8, 13, 14, 15, 12]
[1, 2, 3, 4, 5, 6, 7, 8, 13, 9, 10, 12, 14, 0, 11, 15]
[1, 2, 3, 4, 6, 0, 7, 8, 5, 9, 10, 12, 13, 14, 11, 15]
[1, 2, 3, 4, 5, 6, 7, 8, 10, 13, 11, 12, 9, 0, 14, 15]
[1, 2, 3, 4, 5, 6, 7, 8, 0, 10, 11, 12, 9, 13, 14, 15]
[1, 2, 3, 4, 5, 6, 7, 8, 9, 11, 14, 12, 13, 0, 10, 15]
[0, 1, 2, 4, 5, 6, 3, 8, 9, 10, 7, 12, 13, 14, 11, 15]
[1, 2, 7, 3, 5, 0, 6, 4, 9, 10, 11, 8, 13, 14, 15, 12]
[1, 2, 3, 4, 5, 0, 6, 7, 9, 10, 12, 8, 13, 14, 11, 15]
[1, 2, 3, 4, 5, 6, 7, 8, 9, 10, 0, 15, 13, 14, 12, 11]
[1, 2, 3, 4, 5, 6, 8, 11, 9, 10, 7, 12, 13, 14, 15, 0]
[1, 2, 3, 4, 5, 6, 7, 8, 0, 9, 10, 11, 13, 14, 15, 12]
[1, 2, 0, 4, 5, 7, 3, 8, 9, 6, 10, 11, 13, 14, 15, 12]
[1, 2, 3, 4, 5, 6, 7, 8, 0, 10, 15, 11, 9, 13, 14, 12]
[0, 2, 3, 4, 1, 6, 7, 8, 5, 9, 11, 12, 13, 10, 14, 15]
[1, 2, 0, 3, 5, 6, 7, 4, 9, 10, 12, 8, 13, 14, 11, 15]
[1, 2, 3, 4, 5, 0, 7, 8, 9, 6, 11, 12, 13, 10, 14, 15]
[1, 2, 7, 3, 5, 6, 11, 4, 9, 10, 0, 8, 13, 14, 15, 12]
[1, 2, 3, 4, 5, 6, 7, 8, 9, 14, 10, 11, 13, 15, 12, 0]
[1, 2, 0, 3, 5, 6, 7, 4, 9, 10, 11, 8, 13, 14, 15, 12]
[0, 2, 3, 4, 1, 5, 7, 8, 9, 6, 10, 11, 13, 14, 15, 12]
[1, 2, 3, 4, 5, 6, 7, 8, 13, 9, 10, 11, 14, 0, 15, 12]
[1, 2, 3, 4, 5, 7, 8, 0, 9, 6, 10, 12, 13, 14, 11, 15]
[1, 2, 3, 4, 5, 6, 7, 8, 9, 10, 12, 15, 13, 0, 14, 11]
[1, 3, 0, 4, 5, 2, 6, 7, 9, 10, 11, 8, 13, 14, 15, 12]
[1, 2, 3, 4, 5, 6, 7, 8, 13, 9, 11, 12, 10, 0, 14, 15]
[1, 2, 3, 4, 5, 6, 8, 11, 9, 10, 0, 7, 13, 14, 15, 12]
[1, 2, 3, 4, 9, 5, 6, 8, 0, 10, 7, 11, 13, 14, 15, 12]
[1, 6, 2, 4, 5, 0, 3, 8, 9, 10, 7, 11, 13, 14, 15, 12]
[1, 2, 3, 4, 5, 6, 7, 8, 9, 10, 15, 11, 13, 0, 14, 12]
[0, 1, 2, 4, 5, 6, 3, 7, 9, 10, 11, 8, 13, 14, 15, 12]
[1, 2, 3, 4, 5, 6, 7, 8, 10, 11, 0, 12, 9, 13, 14, 15]
[1, 2, 3, 4, 5, 6, 7, 8, 9, 11, 12, 15, 13, 10, 14, 0]
[0, 2, 3, 4, 1, 6, 7, 8, 5, 10, 11, 12, 9, 13, 14, 15]
[0, 2, 3, 4, 1, 6, 7, 8, 5, 9, 10, 12, 13, 14, 11, 15]
[1, 2, 3, 4, 5, 0, 7, 8, 9, 6, 10, 11, 13, 14, 15, 12]
[1, 2, 3, 4, 5, 6, 7, 8, 0, 9, 11, 12, 13, 10, 14, 15]
[1, 2, 7, 3, 5, 6, 4, 0, 9, 10, 11, 8, 13, 14, 15, 12]
[1, 2, 3, 4, 5, 6, 7, 0, 9, 10, 12, 8, 13, 14, 11, 15]
[0, 2, 3, 4, 1, 5, 6, 8, 9, 10, 7, 12, 13, 14, 11, 15]
[1, 2, 0, 4, 5, 6, 3, 7, 9, 10, 11, 8, 13, 14, 15, 12]
[1, 2, 3, 4, 5, 6, 7, 8, 0, 14, 10, 12, 9, 13, 11, 15]
[1, 2, 3, 4, 5, 0, 7, 8, 10, 6, 11, 12, 9, 13, 14, 15]
[1, 2, 3, 4, 5, 6, 11, 7, 9, 10, 0, 8, 13, 14, 15, 12]
[1, 2, 3, 4, 5, 6, 11, 7, 9, 14, 10, 8, 13, 0, 15, 12]
[1, 2, 3, 4, 5, 6, 7, 8, 9, 14, 10, 12, 13, 0, 11, 15]
[1, 2, 3, 4, 5, 0, 7, 8, 9, 6, 15, 11, 13, 10, 14, 12]
[0, 1, 3, 4, 5, 2, 7, 8, 9, 6, 11, 12, 13, 10, 14, 15]
[1, 2, 0, 3, 5, 6, 8, 4, 9, 10, 7, 12, 13, 14, 11, 15]
[1, 6, 2, 4, 5, 0, 3, 8, 9, 10, 7, 12, 13, 14, 11, 15]
[1, 2, 3, 4, 9, 5, 7, 8, 0, 6, 11, 12, 13, 10, 14, 15]
[1, 2, 3, 4, 5, 6, 11, 7, 9, 10, 15, 8, 13, 0, 14, 12]
[1, 2, 3, 4, 5, 0, 6, 8, 9, 11, 7, 12, 13, 10, 14, 15]
[1, 2, 4, 7, 5, 6, 3, 0, 9, 10, 11, 8, 13, 14, 15, 12]
[1, 2, 3, 4, 5, 6, 8, 0, 9, 10, 7, 11, 13, 14, 15, 12]
[1, 2, 3, 4, 5, 6, 7, 8, 9, 14, 0, 12, 13, 11, 10, 15]
[1, 2, 3, 4, 5, 0, 11, 7, 9, 6, 10, 8, 13, 14, 15, 12]
[0, 2, 3, 4, 1, 5, 7, 8, 9, 6, 10, 12, 13, 14, 11, 15]
[1, 2, 3, 4, 5, 7, 11, 8, 9, 6, 0, 12, 13, 10, 14, 15]
[1, 2, 3, 4, 5, 10, 6, 8, 0, 9, 7, 11, 13, 14, 15, 12]
[1, 2, 3, 4, 5, 0, 6, 8, 9, 10, 7, 11, 13, 14, 15, 12]
[1, 3, 0, 4, 5, 2, 7, 8, 9, 6, 11, 12, 13, 10, 14, 15]
[1, 2, 0, 4, 5, 6, 3, 7, 9, 10, 12, 8, 13, 14, 11, 15]
[1, 2, 3, 4, 5, 6, 7, 8, 9, 14, 10, 11, 13, 0, 15, 12]
[1, 2, 3, 4, 6, 0, 7, 8, 5, 9, 11, 12, 13, 10, 14, 15]
[1, 2, 3, 4, 5, 10, 6, 8, 0, 9, 7, 12, 13, 14, 11, 15]
[1, 2, 3, 4, 5, 10, 6, 7, 9, 11, 0, 8, 13, 14, 15, 12]
[1, 2, 3, 4, 6, 0, 7, 8, 5, 10, 11, 12, 9, 13, 14, 15]
[1, 2, 0, 4, 5, 6, 3, 8, 9, 10, 7, 11, 13, 14, 15, 12]
[1, 3, 0, 4, 5, 2, 7, 8, 9, 6, 10, 12, 13, 14, 11, 15]
[0, 1, 3, 4, 5, 2, 6, 8, 9, 10, 7, 12, 13, 14, 11, 15]
[1, 2, 3, 4, 5, 6, 12, 7, 9, 10, 0, 8, 13, 14, 11, 15]
[1, 2, 3, 4, 5, 10, 6, 8, 9, 7, 0, 12, 13, 14, 11, 15]
[1, 2, 3, 4, 5, 0, 6, 8, 9, 10, 7, 12, 13, 14, 11, 15]
[1, 2, 0, 3, 5, 6, 8, 4, 9, 10, 7, 11, 13, 14, 15, 12]
[1, 2, 3, 4, 9, 5, 6, 8, 0, 10, 7, 12, 13, 14, 11, 15]
[1, 2, 3, 4, 5, 6, 7, 0, 9, 10, 15, 8, 13, 14, 12, 11]
[0, 1, 3, 4, 5, 2, 7, 8, 9, 6, 10, 11, 13, 14, 15, 12]
[1, 2, 3, 4, 5, 6, 8, 0, 9, 11, 7, 12, 13, 10, 14, 15]
[1, 2, 3, 4, 5, 6, 8, 0, 9, 10, 7, 12, 13, 14, 11, 15]
[0, 1, 3, 4, 5, 2, 6, 7, 9, 10, 11, 8, 13, 14, 15, 12]
[0, 1, 2, 4, 5, 6, 3, 8, 9, 10, 7, 11, 13, 14, 15, 12]
[1, 2, 3, 4, 5, 6, 7, 8, 0, 9, 10, 12, 13, 14, 11, 15]
[0, 2, 3, 4, 1, 5, 7, 8, 9, 6, 11, 12, 13, 10, 14, 15]
[1, 2, 3, 4, 5, 7, 8, 0, 9, 6, 11, 12, 13, 10, 14, 15]
[1, 2, 3, 4, 5, 10, 6, 8, 9, 14, 7, 12, 13, 0, 11, 15]
[1, 2, 3, 4, 5, 0, 6, 7, 9, 10, 11, 8, 13, 14, 15, 12]
[1, 2, 4, 8, 5, 6, 3, 0, 9, 10, 7, 12, 13, 14, 11, 15]
[1, 2, 0, 4, 5, 6, 3, 8, 9, 10, 7, 12, 13, 14, 11, 15]
[1, 2, 3, 4, 5, 6, 7, 8, 9, 11, 0, 12, 13, 10, 14, 15]
[1, 2, 3, 4, 5, 6, 11, 7, 9, 10, 15, 8, 13, 14, 12, 0]
[1, 2, 3, 4, 5, 6, 11, 0, 9, 10, 8, 7, 13, 14, 15, 12]
[1, 2, 3, 4, 5, 6, 7, 8, 0, 9, 15, 11, 13, 10, 14, 12]
[1, 2, 3, 4, 9, 5, 6, 7, 0, 10, 11, 8, 13, 14, 15, 12]
[1, 2, 4, 8, 5, 6, 3, 0, 9, 10, 7, 11, 13, 14, 15, 12]
[1, 2, 3, 4, 5, 0, 7, 8, 9, 6, 10, 12, 13, 14, 11, 15]
[1, 2, 3, 4, 5, 10, 6, 8, 9, 7, 0, 11, 13, 14, 15, 12]
[1, 2, 3, 4, 5, 6, 7, 0, 9, 11, 12, 8, 13, 10, 14, 15]
[0, 1, 3, 4, 5, 2, 7, 8, 9, 6, 10, 12, 13, 14, 11, 15]
